10
*
floor1.png 1 0
grass.png 1 0
lava.png 0 1
pinky.png 0 0
wall.png 0 0
water.png 0 1
grass.png 1 0
lava.png 0 1
pinky.png 0 0
wall.png 0 0
water.png 0 1
*
Blank.png
Star.png
Square.png
Pentagon.png
Wall.png
Cloud.png
Circle.png
Arrow.png
Triangle.png
*
1 1 1 1 1 1 1 1 1 1
1 1 1 1 1 7 7 7 7 7
1 1 1 1 1 1 7 7 7 7
1 1 1 1 1 1 7 7 7 7
1 1 1 1 1 7 7 7 7 7
1 1 1 1 1 7 7 7 7 7
1 1 1 1 1 7 7 7 7 7
1 1 1 1 1 7 7 7 7 7
1 1 1 1 1 7 7 7 7 7
1 1 1 1 1 1 1 1 1 1
*
 4  4  4  4  4  4  4  4  4  4  4  4  4  4  4  4  4  4  4  4
 4 -1 -1 -1 -1  4 -1 -1 -1 -1 -1 -1 -1 -1 -1 -1 -1 -1  4  4
 4 -1 -1 -1 -1 -1 -1 -1 -1 -1 -1 -1 -1 -1 -1 -1 -1 -1 -1  4
 4 -1 -1 -1 -1 -1 -1 -1 -1 -1 -1 -1 -1 -1 -1 -1 -1 -1 -1  4
 4 -1 -1 -1 -1 -1 -1 -1 -1 -1 -1  4 -1 -1 -1 -1 -1 -1 -1  4
 4 -1 -1 -1 -1 -1 -1 -1 -1 -1 -1  4 -1 -1 -1 -1 -1 -1 -1  4
 4  4  4  4  4  4 -1 -1 -1 -1 -1  4 -1 -1 -1 -1 -1 -1 -1  4
 4 -1 -1 -1 -1 -1 -1 -1 -1 -1 -1  4 -1 -1 -1 -1 -1 -1 -1  4
 4 -1 -1 -1 -1 -1 -1 -1 -1 -1 -1 -1 -1 -1 -1 -1 -1 -1 -1  4
 4 -1 -1 -1 -1 -1 -1 -1 -1 -1 -1 -1 -1 -1 -1 -1 -1 -1 -1  4
 4 -1 -1 -1 -1 -1 -1 -1 -1 -1 -1 -1 -1 -1 -1 -1 -1 -1 -1  4
 4 -1 -1 -1 -1 -1 -1 -1 -1 -1 -1 -1 -1 -1 -1 -1 -1 -1 -1  4
 4 -1 -1 -1 -1 -1 -1 -1 -1 -1 -1 -1 -1 -1 -1 -1 -1 -1 -1  4
 4 -1 -1 -1 -1  9 -1 -1 10 -1 -1 -1 -1 -1 -1 -1 -1 -1 -1  4
 4 -1 -1 -1 -1  9 -1 -1 10 -1 -1 -1 -1 -1 -1 -1 -1 -1 -1  4
 4 -1 -1 -1 -1 -1 -1 -1 -1 -1 -1 -1 -1 -1 -1 -1 -1 -1 -1  4
 4 -1 -1 -1 -1 -1 -1 -1 -1 -1 -1 -1 -1 -1 -1 -1 -1 -1 -1  4
 4 -1 -1 -1 -1 -1 -1 -1 -1 -1 -1 -1 -1 -1 -1 -1 -1 -1 -1  4
 4  4  4  4  4  4  4  4  4  4  4  4  4  4  4  4  4  4  4  4
-1 -1 -1 -1 -1 -1 -1 -1 -1 -1 -1 -1 -1 -1 -1 -1 -1 -1 -1 -1
*
-1 -1 -1 -1 -1 -1 -1 -1 -1 -1
-1 -1 -1 -1 -1 -1 -1 -1 -1 -1
-1 -1 -1 -1 -1 -1 -1  11 -1 -1
-1 -1 -1 -1 -1 -1 -1 -1 -1 -1
-1 -1 -1 -1 -1 -1 -1 -1 -1 -1
-1 -1 -1 -1 -1 -1 -1 -1 -1 -1
-1 -1 -1 -1 -1 -1 -1 -1 -1 -1
-1 -1 -1 -1 -1 -1 -1 -1 -1 -1
-1 -1 -1 -1 -1 -1 -1 -1 -1 -1
-1 -1 -1 -1 -1 -1 -1 -1 -1 -1
*
BulletTower.png
LaserTower.png
Spikes.png
*