10
*
./Data/Textures/MapTiles/
*
grass.png 1 0
lava.png 0 1
pinky.png 0 0
wall.png 0 0
water.png 0 1
grass.png 1 0
lava.png 0 1
pinky.png 0 0
wall.png 0 0
water.png 0 1
*
Star.png
Square.png
Pentagon.png
Cloud.png
Circle.png
Arrow.png
Triangle.png
*
1 1 1 1 1 1 1 1 1 1
1 1 1 1 1 1 1 1 1 1
1 1 1 1 1 1 1 1 1 1
1 1 1 1 1 1 1 1 1 1
1 1 1 1 1 1 1 1 1 1
1 1 1 1 1 1 1 1 1 1
1 1 1 1 1 1 1 1 1 1
1 1 1 1 1 1 1 1 1 1
1 1 1 1 1 1 1 1 1 1
1 1 1 1 1 1 1 1 1 1
*
 2  2  2  2  2  2  2  2  2  2  2  2  2  2 -1 -1 -1 -1 -1 -1
 2 -1 -1 -1 -1  2 -1 -1 -1 -1 -1 -1 -1  2 -1 -1 -1 -1 -1 -1
 2 -1 -1 -1 -1 -1 -1 -1 -1 -1 -1 -1 -1  2 -1 -1 -1 -1 -1 -1
 2 -1 -1 -1 -1 -1 -1 -1 -1 -1 -1 -1 -1  2 -1 -1 -1 -1 -1 -1
 2 -1 -1 -1 -1  2 -1 -1 -1 -1 -1 -1 -1  2 -1 -1 -1 -1 -1 -1
 2  2  2  2  2  2  2  2  2  2 -1 -1  2  2 -1 -1 -1 -1 -1 -1
-1 -1 -1 -1 -1 -1 -1 -1  2 -1 -1 -1 -1  2 -1 -1 -1 -1 -1 -1
-1  2  2  2  2  2  2  2  2 -1 -1 -1 -1  2  2 -1 -1 -1 -1 -1
 2  2 -1 -1 -1 -1 -1 -1 -1 -1 -1 -1 -1  2 -1 -1 -1 -1 -1 -1
 2  2 -1 -1 -1 -1 -1 -1 -1 -1 -1 -1 -1  2 -1 -1 -1 -1 -1 -1
 2  2 -1 -1  2  2  2  2  2 -1 -1 -1 -1  2 -1 -1 -1 -1 -1 -1
 2  2 -1 -1  2 -1 -1 -1  2  2  2  2  2  2 -1 -1 -1 -1 -1 -1
 2  2 -1 -1  2 -1 -1 -1 -1 -1 -1 -1 -1 -1 -1 -1 -1 -1 -1 -1
 2  2 -1 -1  2 -1 -1 -1 -1 -1 -1 -1 -1 -1 -1 -1 -1 -1 -1 -1
 2  2 -1 -1  2 -1 -1 -1 -1 -1 -1 -1 -1 -1 -1 -1 -1 -1 -1 -1
-1 -1 -1 -1 -1 -1 -1 -1 -1 -1 -1 -1 -1 -1 -1 -1 -1 -1 -1 -1
-1 -1 -1 -1 -1 -1 -1 -1 -1 -1 -1 -1 -1 -1 -1 -1 -1 -1 -1 -1
-1 -1 -1 -1 -1 -1 -1 -1 -1 -1 -1 -1 -1 -1 -1 -1 -1 -1 -1 -1
-1 -1 -1 -1 -1 -1 -1 -1 -1 -1 -1 -1 -1 -1 -1 -1 -1 -1 -1 -1
-1 -1 -1 -1 -1 -1 -1 -1 -1 -1 -1 -1 -1 -1 -1 -1 -1 -1 -1 -1
*