. 01-grass 02-water 03-lava 04-wall 05-pinky
04 04 04 04 04 04 04 04 04 04 04 04 04 04 04 04 
04 05 01 01 01 01 01 01 01 01 01 01 01 01 02 04 
04 01 01 01 01 01 01 01 01 01 01 01 01 01 01 04 
04 01 01 01 01 01 01 01 01 01 01 01 01 01 01 04 
04 01 01 01 01 01 01 01 01 01 01 01 01 01 01 04 
04 01 01 01 01 01 01 05 05 01 01 01 01 01 01 04 
04 01 01 01 01 01 01 05 05 01 01 01 01 01 01 04 
04 01 01 01 01 01 01 01 01 01 01 01 01 01 01 04 
04 01 01 01 01 01 01 01 01 01 01 01 01 01 01 04 
04 01 01 01 01 01 01 01 01 01 01 01 01 01 01 04 
04 01 01 01 01 01 01 01 01 01 01 01 01 01 03 04 
04 04 04 04 04 04 04 04 04 04 04 04 04 04 04 04 